################################
#A      #        #             #
# ####### ###### # ########## #
#       #      # #        #  #
####### # #### # ##### ## # ##
#     # #    # #     #  #    #
# ### # #### # ####### #######
#   # #      #       #       #
# # # ######## ####### ##### #
# # #        #       #     # #
# # ######## # ##### ##### # #
# #        # #     #     #   #
# ######## # ##### ##### ####
#        # #     #       #   #
######## # ####### ####### # #
#        #         #       # #
# ####### ######## # ####### #
#       #        # #       # #
# ##### ######## # ####### # #
#     #          #         B#
################################