#####################
#A    #       #     #
# ### # ##### # ### #
# #   #     # #   # #
# # ####### # ### # #
# #       # #     # #
# ####### # ####### #
#       # #         #
##### # # ######### #
#     # #       #   #
# ##### ####### # ###
#     #       # #   #
# ### ######### ### #
#   #         #     #
### ######### ##### #
#         #   #     #
# ####### # ### ### #
#       # #   #   # #
# ##### # ##### ### #
#     #       #   B #
#####################
